000000000000
0          0
0        5 0
0          0
0    2  1  0
0          0
0 763      0
0         00
0          0
0     8    0
000000000000
            
