000000000000
0  7       0
0    5     0
0          0
0    2  1  0
0          0
0   6      0
0       3 00
0    3     0
0          0
000000000000
            
